###########
#.........#
#.........#
#.....#...#
#.........#
#.........#
#....@....#
#.........#
#...#.....#
#.....#...#
#.........#
###########